....#####...###
###....#..#.###
######...##.###
.######.#...###
#######.#.##...
#######.#..#.#.
#######.###..#.
#######..##.#..
########.#..#.#
########...##..
